8 7
5 4
EWWWWWW
PPPPPPW
WWPWWPW
PPPWWPW
WPWWWWW
WPPPPWW
WWWWWWW
WWWWWWW
WWWWWW
