20 13
6 9
EWWWWWWWPPPWW
PPPPPPWWPWPPW
WWPWWPWWWWWPW
PPPWWPWWWWPPW
WPWWWWWWWPPWW
WPPPPPWWWPPPW
WWWPWPPPPPWPW
WWWPWWWWWWWPW
WWWPWWWWWWWPW
PPPPWWWWWWWPP
WWWPPPPWWWWWP
WWWWWWPWWWWWP
WPPPPPPWWWWWW
WPWWPWWWPPWWW
WPWWPPPPPWWWW
PPWWWWWWPWWWW
WWWWWWWWPWWWW
WWWPPPPPPWWWW
WWWPWWWPWWWWW
WWWPWWWPPPWWW
